GOOMBA
11
20 12 30 12 45 12 49 12 75 12 110 12 107 12 116 12 125 12 150 12 195 12
KOOPA
7
15 11 25 11 78 11 104 11 130 11 140 11 198 11
INTERROGANTE
13
16 9 22 5 21 9 23 9 75 9 91 5 104 9 107 5 107 9 110 9 127 5 128 5 195 9
LADRILLO
27
20 9 22 9 24 9 74 9 76 9 77 5 78 5 79 5 80 5 81 5 82 5 83 5 84 5 88 5 89 5 90 5 91 9 96 9 97 9 116 9 126 5 129 5 127 9 128 9 193 9 194 9 196 9
MONEDA
12
16 9 22 5 23 9 75 9 91 5 107 5 107 9 110 9 128 5 195 9
SETA
2
21 9 127 5
ESTRELLA
1
104 9