TILEMAP 
240 15							-- Size of tile map in tiles
32 32 							-- Tile size & block size
images/agus.png 	-- Tilesheet
8 8 								-- Number of tiles in tilesheet
4 4 4 4 4 4 4 4 4 4 4 4 4 4 4 4 4 4 4 4 4 4 4 4 4 4 4 4 4 4 4 4 4 4 4 4 4 4 4 4 4 4 4 4 4 4 4 4 4 4 4 4 4 4 4 4 4 4 4 4 4 4 4 4 4 4 4 4 4 4 4 4 4 4 4 4 4 4 4 4 4 4 4 4 4 4 4 4 4 4 4 4 4 4 4 4 4 4 4 4 4 4 4 4 4 4 4 4 4 4 4 4 4 4 4 4 4 4 4 4 4 4 4 4 4 4 4 4 4 4 4 4 4 4 4 4 4 4 4 4 4 4 4 4 4 4 4 4 4 4 4 4 4 4 4 4 4 4 4 4 4 4 4 4 4 4 4 4 4 4 4 4 4 4 4 4 4 4 4 4 4 4 4 4 4 4 4 4 4 4 4 4 4 4 4 4 4 4 4 4 4 4 4 4 4 4 4 4 4 4 4 4 4 4 4 4 4 4 4 4 4 4 4 4 4 4 4 4 4 4 4 4 4 4 4 4 4 4 4 4 
4 4 4 4 4 4 4 4 4 17 18 19 4 4 4 4 4 4 4 4 4 4 4 4 4 17 18 19 4 4 4 4 4 4 4 4 4 4 4 4 4 4 4 4 4 4 4 4 4 4 4 4 4 4 4 4 4 4 4 4 4 4 4 4 4 4 4 4 4 4 4 4 4 4 4 4 4 4 4 4 4 4 4 4 4 17 18 19 4 4 4 4 4 4 4 4 4 4 4 4 4 4 4 4 4 4 4 4 17 18 19 4 4 4 4 4 4 4 4 4 4 4 4 4 4 4 4 4 4 4 4 4 17 18 19 4 4 4 4 4 4 4 4 4 4 4 4 4 4 4 4 4 4 4 4 4 4 4 17 18 19 4 4 4 4 4 4 4 4 4 4 4 4 4 4 4 4 4 4 4 4 4 4 4 4 4 4 4 4 4 17 18 19 4 4 4 4 4 4 4 4 4 4 4 4 4 4 4 4 4 4 4 4 4 4 4 4 4 4 4 4 4 4 4 4 4 4 4 4 4 17 18 19 4 4 4 4 4 4 4 
4 4 4 4 4 4 4 4 4 25 26 27 4 4 4 4 4 4 4 4 4 4 4 4 4 25 26 27 4 4 4 4 4 4 4 4 4 4 4 4 4 4 4 4 4 4 4 4 4 4 4 4 4 4 4 4 4 4 4 4 4 4 4 12 4 4 4 4 4 4 4 4 4 4 4 4 4 4 4 4 4 4 4 4 4 25 26 27 4 4 4 4 4 4 4 4 4 4 4 4 4 4 4 4 4 4 4 4 25 26 27 4 4 4 4 4 4 4 4 4 4 4 4 4 4 4 4 4 4 4 4 4 25 26 27 4 4 4 4 4 4 4 4 4 4 4 4 4 4 4 4 4 4 4 4 4 4 4 25 26 27 4 4 4 4 4 4 4 4 4 4 4 4 4 4 4 4 4 4 4 4 4 4 4 4 4 4 4 4 4 25 26 27 4 4 4 4 4 4 4 4 4 4 4 4 4 4 4 4 4 4 4 4 4 4 4 4 4 4 4 4 43 4 4 4 4 4 4 4 4 25 26 27 4 4 4 4 4 4 4 
4 4 4 17 18 19 4 4 4 4 4 4 4 4 4 4 4 4 4 4 4 4 4 4 4 4 4 4 4 4 4 4 4 4 4 4 4 3 3 3 3 3 3 3 3 3 3 3 3 3 3 3 3 3 3 3 3 3 4 4 4 4 4 12 4 4 4 4 4 17 18 19 4 4 4 4 4 4 4 4 4 4 4 4 4 4 4 4 4 4 4 4 4 4 4 4 4 4 4 4 4 4 4 4 4 4 4 4 4 4 4 4 4 4 4 4 4 4 4 4 4 4 4 4 4 4 4 4 4 4 4 4 4 4 4 4 4 4 4 4 4 4 4 4 4 4 4 4 4 4 4 4 4 4 4 4 4 4 4 4 4 4 4 4 4 4 4 4 4 4 4 4 4 4 4 4 4 4 4 4 4 4 4 4 4 4 4 4 4 4 4 4 4 4 4 4 4 4 4 4 4 4 4 4 4 17 18 19 4 4 4 4 4 4 4 4 4 4 4 4 4 51 4 4 4 4 4 4 4 4 4 4 4 4 4 4 4 4 4 4 
4 4 4 25 26 27 4 4 4 4 4 4 4 4 4 4 4 4 4 4 4 4 4 4 4 4 4 4 4 4 4 4 4 4 4 4 4 3 3 3 3 3 3 3 3 3 3 3 3 3 3 3 3 3 3 3 3 3 4 4 4 4 4 12 4 4 4 4 4 25 26 27 4 4 4 4 4 4 4 4 4 4 4 4 4 4 4 4 4 4 4 4 4 4 4 4 4 4 4 4 4 4 4 4 4 4 4 4 4 4 4 4 4 4 4 4 4 4 4 4 4 4 4 4 4 4 4 4 4 4 4 4 4 4 4 4 4 4 4 4 4 4 4 4 4 4 4 4 4 4 4 4 4 4 4 4 4 4 4 4 4 4 4 4 4 4 4 4 4 4 4 4 4 4 4 4 4 4 4 4 4 4 4 4 4 4 4 4 4 4 4 4 4 4 4 4 4 4 4 4 4 4 4 4 12 25 26 27 12 12 4 4 4 4 4 4 4 4 4 4 4 51 4 4 4 4 4 4 4 4 4 4 4 4 4 4 4 4 4 4 
4 4 4 4 4 4 4 4 4 4 4 4 4 4 4 4 4 4 4 4 4 4 4 4 4 4 4 4 17 18 19 4 4 4 4 4 4 3 3 3 4 4 4 4 4 4 4 4 4 4 4 4 4 4 3 3 3 3 4 4 4 4 4 12 4 4 4 4 4 4 4 4 4 4 4 4 4 4 4 4 4 4 4 4 4 4 4 4 4 4 4 4 4 4 4 4 4 4 4 4 4 4 4 4 4 4 4 4 4 4 4 4 4 4 4 4 4 4 4 4 4 4 4 4 4 4 4 4 4 4 4 4 4 4 4 4 4 4 4 4 4 4 4 4 4 4 4 4 4 4 4 4 4 4 4 4 4 4 4 4 4 4 4 4 4 4 4 4 4 4 4 4 4 4 4 4 4 17 18 19 4 4 4 4 4 4 4 4 4 4 4 4 4 4 4 4 4 4 4 4 4 4 4 4 4 12 12 12 12 12 12 42 42 4 4 4 4 4 4 4 4 51 4 4 4 4 4 4 4 4 4 4 4 4 4 4 4 4 17 18 
4 4 4 4 4 4 4 4 4 4 4 4 4 4 4 17 18 19 4 4 4 4 4 4 4 57 58 58 58 59 27 4 4 4 4 4 4 3 3 4 4 4 4 4 4 4 4 4 4 4 4 4 4 4 4 3 3 3 18 19 4 4 4 12 4 4 4 4 4 4 4 4 4 4 4 4 4 4 4 4 4 4 4 17 18 19 4 4 4 4 4 4 4 4 17 18 19 4 4 4 4 4 4 4 4 57 58 58 58 58 59 4 4 4 4 4 4 4 4 4 4 4 4 12 12 12 4 4 4 4 4 4 4 4 4 4 4 4 4 4 4 4 4 4 4 4 4 4 4 4 4 4 4 4 4 4 4 4 4 4 4 4 4 4 4 4 4 4 4 4 4 4 4 4 4 4 4 25 26 27 4 4 4 4 4 4 4 4 4 4 4 4 4 4 4 4 4 4 4 4 4 4 4 4 4 4 4 4 4 4 4 42 42 4 4 4 4 4 4 4 4 51 4 4 4 4 4 4 4 4 4 4 4 4 4 4 4 4 25 26 
4 4 4 4 4 4 4 4 4 4 4 4 4 4 4 25 26 27 4 4 4 4 4 4 4 4 49 49 49 4 4 4 4 4 4 4 4 4 4 4 4 4 4 4 4 4 4 4 4 4 4 4 4 4 4 4 3 3 26 27 4 4 4 12 4 4 4 4 4 4 4 4 4 4 4 4 4 57 58 58 58 58 58 58 58 58 59 12 12 4 4 4 4 4 25 26 27 4 4 4 4 4 4 4 4 4 49 49 49 49 4 4 4 4 4 4 4 4 4 4 4 4 4 12 12 12 4 4 4 4 42 42 42 42 42 4 4 4 4 4 4 4 4 4 4 4 4 4 17 18 19 4 4 4 4 4 4 4 4 4 4 4 4 4 4 4 4 4 4 4 4 4 4 4 4 4 4 4 4 4 4 4 4 4 4 4 4 4 4 4 4 4 4 4 4 4 4 4 4 4 4 4 4 4 4 4 4 4 4 42 42 42 42 4 4 4 4 4 4 4 4 51 4 4 4 4 4 4 4 4 4 4 4 4 4 4 4 4 4 4 
4 5 6 7 4 4 4 4 4 4 4 4 4 4 4 4 4 4 4 4 4 4 4 4 4 4 49 49 49 4 4 4 4 4 4 4 4 4 4 4 4 4 4 4 4 4 4 4 4 4 4 4 4 4 4 4 3 3 4 4 4 4 4 12 4 4 4 4 4 4 4 4 4 4 4 4 4 4 4 49 49 49 49 49 49 12 4 4 4 4 4 4 4 4 4 4 4 4 4 4 4 4 4 4 4 4 49 49 49 49 4 4 4 4 4 4 4 4 4 4 4 4 4 4 4 4 4 4 4 42 42 42 42 42 42 12 4 4 4 4 4 4 4 4 4 4 4 4 25 26 27 4 4 4 4 4 4 4 4 4 4 4 4 4 4 4 4 4 4 4 4 4 4 4 4 4 4 4 4 4 4 4 4 4 4 4 4 4 4 4 4 4 4 4 4 4 4 4 4 4 4 4 4 4 4 4 4 4 4 42 42 42 42 4 4 4 4 4 4 4 4 51 4 4 4 4 5 6 7 4 4 4 4 4 4 4 4 4 4 4 
4 13 14 15 4 4 4 4 4 4 4 4 4 4 4 4 4 4 4 4 4 4 4 57 58 58 58 58 58 58 58 59 4 4 4 4 4 4 4 4 3 4 4 4 4 4 4 4 4 12 4 4 4 4 4 4 3 3 4 4 4 4 4 12 12 4 4 4 4 4 4 4 4 4 4 4 4 4 4 49 49 49 49 49 49 12 4 4 4 4 4 4 4 4 4 4 4 4 4 4 57 58 58 59 4 4 49 49 49 49 4 4 4 4 4 4 4 4 4 4 4 4 4 4 4 4 4 4 42 42 42 42 42 42 42 12 12 12 4 4 4 4 4 4 4 4 4 4 4 4 4 4 4 4 4 4 4 4 4 4 4 4 4 4 4 4 4 4 4 4 4 4 4 4 4 4 4 4 4 4 4 4 4 4 4 4 4 4 4 4 4 4 4 4 4 4 4 4 4 4 4 4 4 4 4 4 4 42 42 42 42 42 42 4 4 4 4 4 4 4 4 51 4 4 4 4 13 14 15 4 4 4 4 4 4 4 4 4 4 4 
20 21 22 23 24 4 4 4 4 4 4 4 4 4 4 4 4 4 4 4 4 4 4 4 49 49 49 49 49 49 49 4 4 4 4 4 4 4 4 4 3 12 12 4 4 4 4 4 4 12 3 3 3 4 4 4 4 3 4 4 4 4 4 4 4 4 4 4 4 4 57 58 58 58 59 4 4 4 4 49 49 49 49 49 49 12 4 4 4 4 4 4 4 4 4 4 4 4 4 4 4 49 49 4 4 4 49 49 49 49 4 4 4 4 4 4 4 4 4 4 4 4 4 4 4 4 42 42 42 42 42 42 42 42 42 12 12 12 12 12 4 4 4 4 42 4 4 4 4 4 4 4 4 4 4 4 4 4 4 4 4 4 4 4 4 4 4 4 4 4 4 4 46 47 48 4 4 4 4 4 4 4 4 4 4 4 4 4 4 57 58 58 58 59 4 4 4 4 4 4 4 4 4 4 4 4 4 42 42 42 42 42 42 4 4 4 4 4 4 4 4 51 4 4 4 20 21 22 23 24 4 4 4 4 4 4 4 4 4 4 
28 29 30 31 32 4 4 4 4 46 47 48 4 4 4 4 4 4 4 4 4 4 4 4 49 49 49 49 49 49 49 4 4 4 4 4 4 4 4 3 3 12 12 12 12 12 12 12 4 12 3 3 3 12 4 4 4 4 4 4 4 4 4 4 4 4 4 4 4 4 4 49 49 49 4 4 4 4 4 49 49 49 49 49 49 57 58 58 58 58 58 59 4 4 4 57 58 58 59 4 4 49 49 4 4 4 49 49 49 49 4 4 4 4 4 4 4 4 4 4 4 4 4 4 4 42 42 42 42 42 42 42 42 42 42 12 12 12 12 12 4 4 4 42 42 4 4 4 42 4 4 4 4 4 46 47 48 4 4 4 4 4 4 4 4 4 4 4 4 4 4 46 54 55 56 4 4 4 4 44 45 4 4 4 4 4 4 4 4 4 49 49 49 4 4 4 4 4 4 4 4 4 4 4 4 4 42 42 42 42 42 42 42 4 4 4 4 4 4 4 4 51 4 4 4 28 29 30 29 32 4 4 4 4 4 4 4 46 47 48 
36 37 38 39 40 9 10 11 12 54 55 56 9 10 11 4 12 57 58 58 59 4 4 4 49 49 49 49 49 49 49 4 4 4 4 4 4 4 4 3 3 12 12 12 4 4 4 12 12 12 3 3 3 12 12 4 4 4 12 4 4 4 4 4 4 4 4 4 4 4 4 49 49 49 4 4 4 4 4 49 49 49 49 49 49 12 12 49 49 49 12 12 4 4 4 4 49 49 4 4 4 49 49 4 4 4 49 49 49 49 4 4 4 4 4 4 4 4 4 4 3 3 3 3 3 3 3 3 3 3 3 3 3 3 3 3 3 3 3 3 3 3 3 3 3 12 12 12 42 42 12 12 12 12 54 55 56 12 12 12 12 4 4 4 4 4 4 4 4 4 4 54 63 64 64 56 4 4 4 52 53 4 4 4 57 58 59 4 4 4 49 49 49 4 4 4 4 4 4 4 4 4 4 4 4 4 42 42 42 42 42 42 42 4 4 4 4 4 4 4 4 42 4 4 4 36 37 38 29 40 4 4 4 4 4 4 4 54 55 56 
3 3 3 3 3 3 3 3 3 3 3 3 3 3 3 4 12 12 49 49 12 12 12 12 49 49 49 49 49 49 49 12 12 12 12 3 3 3 3 3 3 3 3 3 3 3 3 3 3 3 3 3 3 3 3 3 3 3 3 3 12 12 4 3 3 3 3 3 3 12 12 49 49 49 12 12 12 12 12 49 49 49 49 49 49 12 12 49 49 49 12 12 12 12 12 12 49 49 12 12 12 49 49 12 12 12 49 49 49 49 12 12 12 57 58 59 12 12 12 12 3 3 3 3 3 3 3 3 3 3 3 3 3 3 3 3 3 3 3 3 3 3 3 3 3 12 12 12 3 3 3 3 3 3 3 3 3 3 3 3 3 3 3 3 3 3 3 3 3 3 3 3 3 3 3 3 3 3 3 3 3 3 12 12 12 49 12 12 12 12 49 49 49 12 12 4 3 3 3 3 3 3 3 3 3 3 3 3 3 3 3 3 3 3 3 3 3 3 3 3 3 3 3 3 3 3 3 3 3 3 3 3 3 3 3 3 3 3 3 3 
3 3 3 3 3 3 3 3 3 3 3 3 3 3 3 4 12 12 49 49 12 12 12 12 49 49 49 49 49 49 49 12 12 12 12 3 3 3 3 3 3 3 3 3 3 3 3 3 3 3 3 3 3 3 3 3 3 3 3 3 12 12 4 3 3 3 3 3 3 12 12 49 49 49 12 12 12 12 12 49 49 49 49 49 49 12 12 49 49 49 12 12 12 12 12 12 49 49 12 12 12 49 49 12 12 12 49 49 49 49 12 12 12 12 49 12 12 12 12 12 3 3 3 3 3 3 3 3 3 3 3 3 3 3 3 3 3 3 3 3 3 3 3 3 3 12 12 12 3 3 3 3 3 3 3 3 3 3 3 3 3 3 3 3 3 3 3 3 3 3 3 3 3 3 3 3 3 3 3 3 3 3 12 12 12 49 12 12 12 12 49 49 49 12 12 4 3 3 3 3 3 3 3 3 3 3 3 3 3 3 3 3 3 3 3 3 3 3 3 3 3 3 3 3 3 3 3 3 3 3 3 3 3 3 3 3 3 3 3 3