GOOMBA
7
45 12 42 12 136 11 136 17 173 12 177 12 155 12
KOOPA
7
20 10 28 7 82 5 96 9 107 4 190 8 184 10
INTERROGANTE
7
48 10 80 4 83 4 85 8 156 9 161 9 168 5
LADRILLO
10
49 10 81 4 82 4 159 9 160 9 162 9 163 9 167 9 168 9 169 9
MONEDA
8
27 5 28 5 41 12 80 4 83 4 85 8 156 9 168 5
SETA
1
48 10
ESTRELLA
1
161 9